alleged-j_decision-n	I
alleged-j_activity-n	I
alleged-j_culprit-n	I
alleged-j_ring-n	I
alleged-j_sympathy-n	I
alleged-j_quotation-n	I
alleged-j_victim-n	I
alleged-j_statement-n	I
alleged-j_crash-n	I
alleged-j_weakness-n	I
alleged-j_right-n	I
alleged-j_attitude-n	I
alleged-j_misuse-n	I
alleged-j_scheme-n	I
alleged-j_decline-n	I
alleged-j_killer-n	I
alleged-j_affair-n	I
alleged-j_author-n	I
alleged-j_exploitation-n	I
alleged-j_inadequacy-n	I
alleged-j_delay-n	I
alleged-j_report-n	I
alleged-j_condition-n	I
alleged-j_act-n	I
alleged-j_accomplice-n	I
alleged-j_dispute-n	I
alleged-j_call-n	I
alleged-j_fact-n	I
alleged-j_persecution-n	I
alleged-j_possession-n	I
alleged-j_action-n	I
alleged-j_son-n	I
alleged-j_payment-n	I
alleged-j_brutality-n	I
alleged-j_trading-n	I
alleged-j_loss-n	I
alleged-j_connection-n	I
alleged-j_increase-n	I
alleged-j_encounter-n	I
alleged-j_site-n	I
alleged-j_transfer-n	I
alleged-j_program-n	I
alleged-j_difficulty-n	I
alleged-j_concern-n	I
alleged-j_cruelty-n	I
alleged-j_contact-n	I
alleged-j_theft-n	I
alleged-j_bomber-n	I
alleged-j_participant-n	I
alleged-j_suppression-n	I
former-j_bodyguard-n	I
former-j_landfill-n	I
former-j_alumnus-n	I
former-j_ballroom-n	I
former-j_self-n	I
former-j_spy-n	I
former-j_weaver-n	I
former-j_policy-n	I
former-j_neighbor-n	I
former-j_father-in-law-n	I
former-j_adherent-n	I
former-j_examination-n	I
former-j_franchise-n	I
former-j_delegate-n	I
former-j_retreat-n	I
former-j_surname-n	I
former-j_tenant-n	I
former-j_occupant-n	I
former-j_ruler-n	I
former-j_commentator-n	I
former-j_manor-n	I
former-j_chaplain-n	I
former-j_nanny-n	I
former-j_cadet-n	I
former-j_foundry-n	I
former-j_baron-n	I
former-j_chapel-n	I
former-j_sheriff-n	I
former-j_colour-n	I
former-j_estate-n	I
former-j_castle-n	I
former-j_subsidiary-n	I
former-j_jumper-n	I
former-j_cottage-n	I
former-j_electorate-n	I
former-j_examiner-n	I
former-j_mayor-n	I
former-j_team-mate-n	I
former-j_customer-n	I
former-j_provider-n	I
former-j_designation-n	I
former-j_Olympian-n	I
former-j_astronaut-n	I
former-j_allegiance-n	I
former-j_civilization-n	I
former-j_athlete-n	I
former-j_shipyard-n	I
former-j_spinner-n	I
former-j_actor-n	I
former-j_sailor-n	I
future-j_selection-n	I
future-j_knowledge-n	I
future-j_scheme-n	I
future-j_yield-n	I
future-j_material-n	I
future-j_list-n	I
future-j_licence-n	I
future-j_decision-making-n	I
future-j_tax-n	I
future-j_step-n	I
future-j_concern-n	I
future-j_month-n	I
future-j_fall-n	I
future-j_acquisition-n	I
future-j_storage-n	I
future-j_wellbeing-n	I
future-j_downloads-n	I
future-j_composition-n	I
future-j_doctor-n	I
future-j_career-n	I
future-j_guidance-n	I
future-j_contest-n	I
future-j_context-n	I
future-j_match-n	I
future-j_wave-n	I
future-j_iteration-n	I
future-j_unit-n	I
future-j_execution-n	I
future-j_tragedy-n	I
future-j_politics-n	I
future-j_engine-n	I
future-j_voice-n	I
future-j_capital-n	I
future-j_merger-n	I
future-j_commission-n	I
future-j_prospect-n	I
future-j_producer-n	I
future-j_pioneer-n	I
future-j_opponent-n	I
future-j_importance-n	I
future-j_saint-n	I
future-j_expense-n	I
future-j_copyright-n	I
future-j_trip-n	I
future-j_title-n	I
future-j_page-n	I
future-j_child-n	I
future-j_fight-n	I
future-j_team-mate-n	I
future-j_treatment-n	I
hypothetical-j_route-n	I
hypothetical-j_invasion-n	I
hypothetical-j_structure-n	I
hypothetical-j_game-n	I
hypothetical-j_experiment-n	I
hypothetical-j_charge-n	I
hypothetical-j_position-n	I
hypothetical-j_service-n	I
hypothetical-j_function-n	I
hypothetical-j_patient-n	I
hypothetical-j_program-n	I
hypothetical-j_cost-n	I
hypothetical-j_tax-n	I
hypothetical-j_relationship-n	I
hypothetical-j_observer-n	I
hypothetical-j_nature-n	I
hypothetical-j_molecule-n	I
hypothetical-j_version-n	I
hypothetical-j_choice-n	I
hypothetical-j_calculation-n	I
hypothetical-j_clock-n	I
hypothetical-j_mechanism-n	I
hypothetical-j_user-n	I
hypothetical-j_energy-n	I
hypothetical-j_language-n	I
hypothetical-j_effect-n	I
hypothetical-j_line-n	I
hypothetical-j_project-n	I
hypothetical-j_fact-n	I
hypothetical-j_development-n	I
hypothetical-j_process-n	I
hypothetical-j_group-n	I
hypothetical-j_sequence-n	I
hypothetical-j_force-n	I
hypothetical-j_connection-n	I
hypothetical-j_design-n	I
hypothetical-j_level-n	I
hypothetical-j_proposition-n	I
hypothetical-j_election-n	I
hypothetical-j_vendor-n	I
hypothetical-j_dilemma-n	I
hypothetical-j_action-n	I
hypothetical-j_event-n	I
hypothetical-j_possibility-n	I
hypothetical-j_imperative-n	I
hypothetical-j_source-n	I
hypothetical-j_application-n	I
hypothetical-j_construct-n	I
hypothetical-j_condition-n	I
hypothetical-j_tenant-n	I
impossible-j_point-n	I
impossible-j_trick-n	I
impossible-j_triangle-n	I
impossible-j_dream-n	I
impossible-j_creation-n	I
impossible-j_game-n	I
impossible-j_compromise-n	I
impossible-j_review-n	I
impossible-j_crime-n	I
impossible-j_obstacle-n	I
impossible-j_standard-n	I
impossible-j_escape-n	I
impossible-j_act-n	I
impossible-j_world-n	I
impossible-j_structure-n	I
impossible-j_system-n	I
impossible-j_explanation-n	I
impossible-j_aim-n	I
impossible-j_amount-n	I
impossible-j_victory-n	I
impossible-j_notion-n	I
impossible-j_proposal-n	I
impossible-j_plan-n	I
impossible-j_proposition-n	I
impossible-j_space-n	I
impossible-j_country-n	I
impossible-j_mission-n	I
impossible-j_situation-n	I
impossible-j_concept-n	I
impossible-j_anatomy-n	I
impossible-j_problem-n	I
impossible-j_figure-n	I
impossible-j_environment-n	I
impossible-j_area-n	I
impossible-j_cube-n	I
impossible-j_goal-n	I
impossible-j_course-n	I
impossible-j_word-n	I
impossible-j_group-n	I
impossible-j_contract-n	I
impossible-j_case-n	I
impossible-j_reality-n	I
impossible-j_strain-n	I
impossible-j_balance-n	I
impossible-j_time-n	I
impossible-j_way-n	I
impossible-j_year-n	I
impossible-j_test-n	I
impossible-j_planet-n	I
impossible-j_story-n	I
likely-j_pupil-n	I
likely-j_thought-n	I
likely-j_voter-n	I
likely-j_area-n	I
likely-j_issue-n	I
likely-j_fate-n	I
likely-j_policy-n	I
likely-j_bill-n	I
likely-j_concern-n	I
likely-j_delay-n	I
likely-j_rate-n	I
likely-j_company-n	I
likely-j_split-n	I
likely-j_threat-n	I
likely-j_team-n	I
likely-j_replacement-n	I
likely-j_manner-n	I
likely-j_employee-n	I
likely-j_population-n	I
likely-j_base-n	I
likely-j_sequence-n	I
likely-j_share-n	I
likely-j_difficulty-n	I
likely-j_game-n	I
likely-j_document-n	I
likely-j_line-up-n	I
likely-j_participant-n	I
likely-j_infection-n	I
likely-j_evolution-n	I
likely-j_measure-n	I
likely-j_approach-n	I
likely-j_total-n	I
likely-j_reality-n	I
likely-j_notation-n	I
likely-j_presence-n	I
likely-j_potential-n	I
likely-j_hazard-n	I
likely-j_opportunity-n	I
likely-j_class-n	I
likely-j_subject-n	I
likely-j_concentration-n	I
likely-j_fall-n	I
likely-j_casualty-n	I
likely-j_income-n	I
likely-j_budget-n	I
likely-j_crime-n	I
likely-j_usage-n	I
likely-j_place-n	I
likely-j_force-n	I
likely-j_series-n	I
mere-j_province-n	I
mere-j_fiction-n	I
mere-j_point-n	I
mere-j_difference-n	I
mere-j_movement-n	I
mere-j_sum-n	I
mere-j_association-n	I
mere-j_phenomenon-n	I
mere-j_coincidence-n	I
mere-j_example-n	I
mere-j_invention-n	I
mere-j_vote-n	I
mere-j_pound-n	I
mere-j_religion-n	I
mere-j_genus-n	I
mere-j_symptom-n	I
mere-j_consumer-n	I
mere-j_statistic-n	I
mere-j_technique-n	I
mere-j_convention-n	I
mere-j_machine-n	I
mere-j_play-n	I
mere-j_compliance-n	I
mere-j_decoration-n	I
mere-j_power-n	I
mere-j_people-n	I
mere-j_gesture-n	I
mere-j_toy-n	I
mere-j_spectator-n	I
mere-j_creature-n	I
mere-j_chance-n	I
mere-j_yard-n	I
mere-j_part-n	I
mere-j_resource-n	I
mere-j_event-n	I
mere-j_relation-n	I
mere-j_curiosity-n	I
mere-j_meter-n	I
mere-j_continuation-n	I
mere-j_convenience-n	I
mere-j_threat-n	I
mere-j_age-n	I
mere-j_fragment-n	I
mere-j_assertion-n	I
mere-j_tool-n	I
mere-j_mean-n	I
mere-j_month-n	I
mere-j_name-n	I
mere-j_half-n	I
mere-j_observation-n	I
mock-j_terror-n	I
mock-j_name-n	I
mock-j_soup-n	I
mock-j_fear-n	I
mock-j_ticket-n	I
mock-j_sun-n	I
mock-j_advert-n	I
mock-j_function-n	I
mock-j_jury-n	I
mock-j_room-n	I
mock-j_survey-n	I
mock-j_auction-n	I
mock-j_town-n	I
mock-j_excavation-n	I
mock-j_ceremony-n	I
mock-j_celebration-n	I
mock-j_law-n	I
mock-j_mediation-n	I
mock-j_argument-n	I
mock-j_documentary-n	I
mock-j_innocence-n	I
mock-j_station-n	I
mock-j_trial-n	I
mock-j_form-n	I
mock-j_landing-n	I
mock-j_book-n	I
mock-j_operation-n	I
mock-j_rescue-n	I
mock-j_campaign-n	I
mock-j_turtle-n	I
mock-j_accent-n	I
mock-j_film-n	I
mock-j_salute-n	I
mock-j_script-n	I
mock-j_environment-n	I
mock-j_session-n	I
mock-j_player-n	I
mock-j_castle-n	I
mock-j_hearing-n	I
mock-j_house-n	I
mock-j_event-n	I
mock-j_people-n	I
mock-j_ship-n	I
mock-j_sincerity-n	I
mock-j_hanging-n	I
mock-j_right-n	I
mock-j_charge-n	I
mock-j_value-n	I
mock-j_wall-n	I
mock-j_presentation-n	I
necessary-j_introduction-n	I
necessary-j_speed-n	I
necessary-j_jurisdiction-n	I
necessary-j_discussion-n	I
necessary-j_detail-n	I
necessary-j_model-n	I
necessary-j_presence-n	I
necessary-j_processing-n	I
necessary-j_reservation-n	I
necessary-j_ingredient-n	I
necessary-j_competence-n	I
necessary-j_card-n	I
necessary-j_enquiry-n	I
necessary-j_grant-n	I
necessary-j_bit-n	I
necessary-j_subject-n	I
necessary-j_refurbishment-n	I
necessary-j_absence-n	I
necessary-j_cash-n	I
necessary-j_lead-n	I
necessary-j_recommendation-n	I
necessary-j_password-n	I
necessary-j_meeting-n	I
necessary-j_staff-n	I
necessary-j_medicine-n	I
necessary-j_certificate-n	I
necessary-j_difference-n	I
necessary-j_increase-n	I
necessary-j_department-n	I
necessary-j_contact-n	I
necessary-j_cause-n	I
necessary-j_assumption-n	I
necessary-j_rule-n	I
necessary-j_parameter-n	I
necessary-j_modification-n	I
necessary-j_image-n	I
necessary-j_software-n	I
necessary-j_fuel-n	I
necessary-j_examination-n	I
necessary-j_recognition-n	I
necessary-j_nutrient-n	I
necessary-j_site-n	I
necessary-j_stop-n	I
necessary-j_help-n	I
necessary-j_amount-n	I
necessary-j_threshold-n	I
necessary-j_finding-n	I
necessary-j_phase-n	I
necessary-j_finance-n	I
necessary-j_content-n	I
past-j_location-n	I
past-j_memory-n	I
past-j_venue-n	I
past-j_dealing-n	I
past-j_player-n	I
past-j_organization-n	I
past-j_working-n	I
past-j_lover-n	I
past-j_exhibitor-n	I
past-j_decision-n	I
past-j_figure-n	I
past-j_romance-n	I
past-j_dissertation-n	I
past-j_second-n	I
past-j_country-n	I
past-j_camp-n	I
past-j_spring-n	I
past-j_treasurer-n	I
past-j_session-n	I
past-j_meaning-n	I
past-j_matter-n	I
past-j_affiliation-n	I
past-j_injury-n	I
past-j_community-n	I
past-j_version-n	I
past-j_drive-n	I
past-j_project-n	I
past-j_worker-n	I
past-j_age-n	I
past-j_range-n	I
past-j_bishop-n	I
past-j_claim-n	I
past-j_life-n	I
past-j_summer-n	I
past-j_topic-n	I
past-j_midday-n	I
past-j_goal-n	I
past-j_bridge-n	I
past-j_interpretation-n	I
past-j_form-n	I
past-j_intervention-n	I
past-j_identity-n	I
past-j_commander-n	I
past-j_culture-n	I
past-j_essay-n	I
past-j_employee-n	I
past-j_injustice-n	I
past-j_politician-n	I
past-j_secret-n	I
past-j_sentence-n	I
possible-j_stream-n	I
possible-j_problem-n	I
possible-j_rule-n	I
possible-j_community-n	I
possible-j_allergy-n	I
possible-j_song-n	I
possible-j_addition-n	I
possible-j_mutation-n	I
possible-j_peace-n	I
possible-j_collector-n	I
possible-j_market-n	I
possible-j_tendency-n	I
possible-j_series-n	I
possible-j_method-n	I
possible-j_warning-n	I
possible-j_phenomenon-n	I
possible-j_subset-n	I
possible-j_pit-n	I
possible-j_snow-n	I
possible-j_public-n	I
possible-j_side-effect-n	I
possible-j_run-n	I
possible-j_triangle-n	I
possible-j_supervisor-n	I
possible-j_reaction-n	I
possible-j_code-n	I
possible-j_distribution-n	I
possible-j_hazard-n	I
possible-j_load-n	I
possible-j_welcome-n	I
possible-j_date-n	I
possible-j_development-n	I
possible-j_house-n	I
possible-j_agenda-n	I
possible-j_approximation-n	I
possible-j_approval-n	I
possible-j_map-n	I
possible-j_level-n	I
possible-j_change-n	I
possible-j_intrusion-n	I
possible-j_recession-n	I
possible-j_description-n	I
possible-j_alternative-n	I
possible-j_dissemination-n	I
possible-j_documentation-n	I
possible-j_predictor-n	I
possible-j_tactic-n	I
possible-j_ground-n	I
possible-j_friend-n	I
possible-j_genotype-n	I
potential-j_instrument-n	I
potential-j_development-n	I
potential-j_deal-n	I
potential-j_danger-n	I
potential-j_solution-n	I
potential-j_link-n	I
potential-j_entitlement-n	I
potential-j_supervisor-n	I
potential-j_combination-n	I
potential-j_winner-n	I
potential-j_quality-n	I
potential-j_trainee-n	I
potential-j_method-n	I
potential-j_removal-n	I
potential-j_treatment-n	I
potential-j_attacker-n	I
potential-j_equation-n	I
potential-j_deficiency-n	I
potential-j_precursor-n	I
potential-j_source-n	I
potential-j_delay-n	I
potential-j_mediator-n	I
potential-j_advance-n	I
potential-j_sign-n	I
potential-j_scheme-n	I
potential-j_consequence-n	I
potential-j_epidemic-n	I
potential-j_financier-n	I
potential-j_customer-n	I
potential-j_shift-n	I
potential-j_sentence-n	I
potential-j_learning-n	I
potential-j_form-n	I
potential-j_victim-n	I
potential-j_arrangement-n	I
potential-j_interpretation-n	I
potential-j_obligation-n	I
potential-j_club-n	I
potential-j_exploitation-n	I
potential-j_participant-n	I
potential-j_movement-n	I
potential-j_representative-n	I
potential-j_symptom-n	I
potential-j_contract-n	I
potential-j_capacity-n	I
potential-j_defect-n	I
potential-j_salary-n	I
potential-j_engineer-n	I
potential-j_collapse-n	I
potential-j_maker-n	I
presumed-j_heir-n	I
presumed-j_sexuality-n	I
presumed-j_candidate-n	I
presumed-j_reason-n	I
presumed-j_stage-n	I
presumed-j_connection-n	I
presumed-j_state-n	I
presumed-j_source-n	I
presumed-j_capability-n	I
presumed-j_ancestor-n	I
presumed-j_feature-n	I
presumed-j_benefit-n	I
presumed-j_power-n	I
presumed-j_reality-n	I
presumed-j_threat-n	I
presumed-j_brother-n	I
presumed-j_death-n	I
presumed-j_character-n	I
presumed-j_role-n	I
presumed-j_son-n	I
presumed-j_inability-n	I
presumed-j_criminal-n	I
presumed-j_strength-n	I
presumed-j_innocence-n	I
presumed-j_victim-n	I
presumed-j_quality-n	I
presumed-j_way-n	I
presumed-j_specie-n	I
presumed-j_man-n	I
presumed-j_intention-n	I
presumed-j_right-n	I
presumed-j_site-n	I
presumed-j_homosexual-n	I
presumed-j_route-n	I
presumed-j_objectivity-n	I
presumed-j_mother-n	I
presumed-j_origin-n	I
presumed-j_form-n	I
presumed-j_system-n	I
presumed-j_subject-n	I
presumed-j_lover-n	I
presumed-j_wish-n	I
presumed-j_article-n	I
presumed-j_number-n	I
presumed-j_crime-n	I
presumed-j_line-n	I
presumed-j_father-n	I
presumed-j_assassin-n	I
presumed-j_action-n	I
presumed-j_hybrid-n	I
probable-j_effect-n	I
probable-j_length-n	I
probable-j_loss-n	I
probable-j_difficulty-n	I
probable-j_extinction-n	I
probable-j_appearance-n	I
probable-j_reaction-n	I
probable-j_age-n	I
probable-j_expense-n	I
probable-j_change-n	I
probable-j_identity-n	I
probable-j_account-n	I
probable-j_trend-n	I
probable-j_ascent-n	I
probable-j_risk-n	I
probable-j_amount-n	I
probable-j_route-n	I
probable-j_solution-n	I
probable-j_benefit-n	I
probable-j_cause-n	I
probable-j_model-n	I
probable-j_resource-n	I
probable-j_transaction-n	I
probable-j_interest-n	I
probable-j_use-n	I
probable-j_example-n	I
probable-j_implication-n	I
probable-j_meaning-n	I
probable-j_hypothesis-n	I
probable-j_outcome-n	I
probable-j_involvement-n	I
probable-j_conjecture-n	I
probable-j_origin-n	I
probable-j_answer-n	I
probable-j_method-n	I
probable-j_range-n	I
probable-j_mode-n	I
probable-j_size-n	I
probable-j_line-n	I
probable-j_lack-n	I
probable-j_knowledge-n	I
probable-j_frequency-n	I
probable-j_importance-n	I
probable-j_burial-n	I
probable-j_spam-n	I
probable-j_evidence-n	I
probable-j_number-n	I
probable-j_rate-n	I
probable-j_disease-n	I
probable-j_starter-n	I
putative-j_knowledge-n	I
putative-j_activity-n	I
putative-j_member-n	I
putative-j_branch-n	I
putative-j_partner-n	I
putative-j_father-n	I
putative-j_victim-n	I
putative-j_parent-n	I
putative-j_ancestor-n	I
putative-j_structure-n	I
putative-j_event-n	I
putative-j_test-n	I
putative-j_condition-n	I
putative-j_protein-n	I
putative-j_gene-n	I
putative-j_value-n	I
putative-j_target-n	I
putative-j_point-n	I
putative-j_descendant-n	I
putative-j_mechanism-n	I
putative-j_benefit-n	I
putative-j_transcript-n	I
putative-j_date-n	I
putative-j_example-n	I
putative-j_evidence-n	I
putative-j_attack-n	I
putative-j_right-n	I
putative-j_enzyme-n	I
putative-j_status-n	I
putative-j_element-n	I
putative-j_region-n	I
putative-j_object-n	I
putative-j_influence-n	I
putative-j_marriage-n	I
putative-j_form-n	I
putative-j_action-n	I
putative-j_hybrid-n	I
putative-j_fact-n	I
putative-j_location-n	I
putative-j_language-n	I
putative-j_mutation-n	I
putative-j_transporter-n	I
putative-j_origin-n	I
putative-j_population-n	I
putative-j_author-n	I
putative-j_genotype-n	I
putative-j_phenomenon-n	I
putative-j_insurer-n	I
putative-j_source-n	I
putative-j_contribution-n	I
theoretical-j_rationale-n	I
theoretical-j_consideration-n	I
theoretical-j_curve-n	I
theoretical-j_calculation-n	I
theoretical-j_specification-n	I
theoretical-j_advantage-n	I
theoretical-j_design-n	I
theoretical-j_form-n	I
theoretical-j_awareness-n	I
theoretical-j_estimate-n	I
theoretical-j_response-n	I
theoretical-j_explanation-n	I
theoretical-j_argument-n	I
theoretical-j_situation-n	I
theoretical-j_guide-n	I
theoretical-j_criticism-n	I
theoretical-j_distinction-n	I
theoretical-j_origin-n	I
theoretical-j_root-n	I
theoretical-j_resource-n	I
theoretical-j_component-n	I
theoretical-j_weight-n	I
theoretical-j_course-n	I
theoretical-j_information-n	I
theoretical-j_statistic-n	I
theoretical-j_extension-n	I
theoretical-j_condition-n	I
theoretical-j_world-n	I
theoretical-j_group-n	I
theoretical-j_bandwidth-n	I
theoretical-j_system-n	I
theoretical-j_application-n	I
theoretical-j_sampling-n	I
theoretical-j_right-n	I
theoretical-j_class-n	I
theoretical-j_bar-n	I
theoretical-j_angle-n	I
theoretical-j_elaboration-n	I
theoretical-j_solution-n	I
theoretical-j_finding-n	I
theoretical-j_proof-n	I
theoretical-j_essay-n	I
theoretical-j_case-n	I
theoretical-j_relationship-n	I
theoretical-j_expectation-n	I
theoretical-j_examination-n	I
theoretical-j_engagement-n	I
theoretical-j_reason-n	I
theoretical-j_possibility-n	I
theoretical-j_sense-n	I
black-j_plate-n	N
black-j_female-n	N
black-j_slavery-n	N
black-j_film-n	N
black-j_male-n	N
black-j_nylon-n	N
black-j_cartoon-n	N
black-j_lab-n	N
black-j_nation-n	N
black-j_shadow-n	N
black-j_tube-n	N
black-j_network-n	N
black-j_dancer-n	N
black-j_member-n	N
black-j_contrast-n	N
black-j_glass-n	N
black-j_foot-n	N
black-j_sportsman-n	N
black-j_information-n	N
black-j_monitor-n	N
black-j_knife-n	N
black-j_datum-n	N
black-j_box-n	N
black-j_bin-n	N
black-j_dust-n	N
black-j_cinema-n	N
black-j_gate-n	N
black-j_belt-n	N
black-j_plant-n	N
black-j_road-n	N
black-j_nurse-n	N
black-j_residue-n	N
black-j_wire-n	N
black-j_furniture-n	N
black-j_pot-n	N
black-j_laborer-n	N
black-j_ghost-n	N
black-j_surface-n	N
black-j_wallet-n	N
black-j_kid-n	N
black-j_number-n	N
black-j_value-n	N
black-j_colleague-n	N
black-j_reaction-n	N
black-j_volunteer-n	N
black-j_tenant-n	N
black-j_fruit-n	N
black-j_format-n	N
black-j_poker-n	N
black-j_individual-n	N
free-j_finish-n	N
free-j_cartridge-n	N
free-j_snack-n	N
free-j_transportation-n	N
free-j_custom-n	N
free-j_attention-n	N
free-j_salt-n	N
free-j_commonwealth-n	N
free-j_clothes-n	N
free-j_emission-n	N
free-j_village-n	N
free-j_set-up-n	N
free-j_testing-n	N
free-j_laptop-n	N
free-j_journey-n	N
free-j_craft-n	N
free-j_environment-n	N
free-j_pick-n	N
free-j_download-n	N
free-j_furniture-n	N
free-j_chance-n	N
free-j_summer-n	N
free-j_texas-n	N
free-j_tuition-n	N
free-j_background-n	N
free-j_study-n	N
free-j_podcast-n	N
free-j_effect-n	N
free-j_subscriber-n	N
free-j_operator-n	N
free-j_structure-n	N
free-j_advantage-n	N
free-j_pitcher-n	N
free-j_wind-n	N
free-j_bay-n	N
free-j_help-n	N
free-j_law-n	N
free-j_auction-n	N
free-j_centre-n	N
free-j_adult-n	N
free-j_report-n	N
free-j_styling-n	N
free-j_consent-n	N
free-j_fun-n	N
free-j_card-n	N
free-j_citizenship-n	N
free-j_sampling-n	N
free-j_entertainment-n	N
free-j_thought-n	N
free-j_travel-n	N
hard-j_muscle-n	N
hard-j_breathing-n	N
hard-j_mountain-n	N
hard-j_necessity-n	N
hard-j_school-n	N
hard-j_trick-n	N
hard-j_service-n	N
hard-j_hike-n	N
hard-j_substrate-n	N
hard-j_month-n	N
hard-j_attitude-n	N
hard-j_glass-n	N
hard-j_object-n	N
hard-j_granite-n	N
hard-j_chair-n	N
hard-j_shoe-n	N
hard-j_segment-n	N
hard-j_science-n	N
hard-j_character-n	N
hard-j_space-n	N
hard-j_result-n	N
hard-j_effect-n	N
hard-j_acid-n	N
hard-j_mine-n	N
hard-j_boat-n	N
hard-j_land-n	N
hard-j_shift-n	N
hard-j_access-n	N
hard-j_view-n	N
hard-j_finish-n	N
hard-j_rule-n	N
hard-j_child-n	N
hard-j_path-n	N
hard-j_sound-n	N
hard-j_bone-n	N
hard-j_biscuit-n	N
hard-j_shell-n	N
hard-j_match-n	N
hard-j_bay-n	N
hard-j_luggage-n	N
hard-j_case-n	N
hard-j_crash-n	N
hard-j_usage-n	N
hard-j_form-n	N
hard-j_skeleton-n	N
hard-j_activity-n	N
hard-j_scale-n	N
hard-j_luck-n	N
hard-j_volume-n	N
hard-j_team-n	N
intelligent-j_supporter-n	N
intelligent-j_tutor-n	N
intelligent-j_appliance-n	N
intelligent-j_customer-n	N
intelligent-j_function-n	N
intelligent-j_footballer-n	N
intelligent-j_professional-n	N
intelligent-j_speed-n	N
intelligent-j_creature-n	N
intelligent-j_car-n	N
intelligent-j_vehicle-n	N
intelligent-j_person-n	N
intelligent-j_computer-n	N
intelligent-j_database-n	N
intelligent-j_infrastructure-n	N
intelligent-j_people-n	N
intelligent-j_opinion-n	N
intelligent-j_user-n	N
intelligent-j_option-n	N
intelligent-j_soul-n	N
intelligent-j_use-n	N
intelligent-j_support-n	N
intelligent-j_content-n	N
intelligent-j_algorithm-n	N
intelligent-j_company-n	N
intelligent-j_drive-n	N
intelligent-j_assistant-n	N
intelligent-j_source-n	N
intelligent-j_technique-n	N
intelligent-j_eye-n	N
intelligent-j_environment-n	N
intelligent-j_lighting-n	N
intelligent-j_humor-n	N
intelligent-j_system-n	N
intelligent-j_politician-n	N
intelligent-j_delivery-n	N
intelligent-j_group-n	N
intelligent-j_comment-n	N
intelligent-j_pop-n	N
intelligent-j_show-n	N
intelligent-j_life-n	N
intelligent-j_component-n	N
intelligent-j_capability-n	N
intelligent-j_proponent-n	N
intelligent-j_terminal-n	N
intelligent-j_audience-n	N
intelligent-j_management-n	N
intelligent-j_machine-n	N
intelligent-j_friend-n	N
intelligent-j_design-n	N
loose-j_narrative-n	N
loose-j_equipment-n	N
loose-j_cotton-n	N
loose-j_feeding-n	N
loose-j_bag-n	N
loose-j_game-n	N
loose-j_fur-n	N
loose-j_adaptation-n	N
loose-j_opinion-n	N
loose-j_plumage-n	N
loose-j_block-n	N
loose-j_coat-n	N
loose-j_horse-n	N
loose-j_shale-n	N
loose-j_translation-n	N
loose-j_coin-n	N
loose-j_area-n	N
loose-j_edge-n	N
loose-j_leave-n	N
loose-j_type-n	N
loose-j_arc-n	N
loose-j_plate-n	N
loose-j_rule-n	N
loose-j_term-n	N
loose-j_fragment-n	N
loose-j_interpretation-n	N
loose-j_grouping-n	N
loose-j_leaf-n	N
loose-j_hand-n	N
loose-j_grip-n	N
loose-j_material-n	N
loose-j_bolt-n	N
loose-j_approach-n	N
loose-j_partnership-n	N
loose-j_skin-n	N
loose-j_version-n	N
loose-j_sequel-n	N
loose-j_category-n	N
loose-j_organization-n	N
loose-j_dirt-n	N
loose-j_offering-n	N
loose-j_usage-n	N
loose-j_rug-n	N
loose-j_bundle-n	N
loose-j_number-n	N
loose-j_plot-n	N
loose-j_home-n	N
loose-j_language-n	N
loose-j_chip-n	N
loose-j_pebble-n	N
meagre-j_subsistence-n	N
meagre-j_average-n	N
meagre-j_lunch-n	N
meagre-j_knowledge-n	N
meagre-j_pension-n	N
meagre-j_beach-n	N
meagre-j_diet-n	N
meagre-j_gain-n	N
meagre-j_attempt-n	N
meagre-j_wage-n	N
meagre-j_level-n	N
meagre-j_time-n	N
meagre-j_effort-n	N
meagre-j_response-n	N
meagre-j_skill-n	N
meagre-j_stock-n	N
meagre-j_remain-n	N
meagre-j_material-n	N
meagre-j_fare-n	N
meagre-j_pay-n	N
meagre-j_audience-n	N
meagre-j_return-n	N
meagre-j_figure-n	N
meagre-j_information-n	N
meagre-j_money-n	N
meagre-j_cost-n	N
meagre-j_profit-n	N
meagre-j_tally-n	N
meagre-j_meal-n	N
meagre-j_year-n	N
meagre-j_scrap-n	N
meagre-j_harvest-n	N
meagre-j_food-n	N
meagre-j_vocabulary-n	N
meagre-j_belonging-n	N
meagre-j_percent-n	N
meagre-j_existence-n	N
meagre-j_mean-n	N
meagre-j_support-n	N
meagre-j_ration-n	N
meagre-j_content-n	N
meagre-j_amount-n	N
meagre-j_doctor-n	N
meagre-j_investment-n	N
meagre-j_rate-n	N
meagre-j_allowance-n	N
meagre-j_point-n	N
meagre-j_fee-n	N
meagre-j_part-n	N
meagre-j_goal-n	N
modern-j_archery-n	N
modern-j_baseball-n	N
modern-j_eye-n	N
modern-j_memory-n	N
modern-j_warehouse-n	N
modern-j_advancement-n	N
modern-j_scenario-n	N
modern-j_civilisation-n	N
modern-j_window-n	N
modern-j_disease-n	N
modern-j_competition-n	N
modern-j_communism-n	N
modern-j_revolution-n	N
modern-j_list-n	N
modern-j_thought-n	N
modern-j_branch-n	N
modern-j_world-n	N
modern-j_monument-n	N
modern-j_satellite-n	N
modern-j_consumer-n	N
modern-j_lover-n	N
modern-j_range-n	N
modern-j_gearbox-n	N
modern-j_surface-n	N
modern-j_culture-n	N
modern-j_society-n	N
modern-j_aircraft-n	N
modern-j_textbook-n	N
modern-j_photo-n	N
modern-j_prose-n	N
modern-j_visitor-n	N
modern-j_outlet-n	N
modern-j_material-n	N
modern-j_port-n	N
modern-j_carol-n	N
modern-j_jurisprudence-n	N
modern-j_intellectual-n	N
modern-j_receiver-n	N
modern-j_steel-n	N
modern-j_venue-n	N
modern-j_battle-n	N
modern-j_geographer-n	N
modern-j_opportunity-n	N
modern-j_year-n	N
modern-j_horn-n	N
modern-j_timber-n	N
modern-j_comic-n	N
modern-j_van-n	N
modern-j_ballet-n	N
modern-j_protocol-n	N
naive-j_public-n	N
naive-j_fool-n	N
naive-j_algorithm-n	N
naive-j_user-n	N
naive-j_teenager-n	N
naive-j_belief-n	N
naive-j_implementation-n	N
naive-j_one-n	N
naive-j_programmer-n	N
naive-j_assumption-n	N
naive-j_allegory-n	N
naive-j_fantasy-n	N
naive-j_form-n	N
naive-j_owner-n	N
naive-j_author-n	N
naive-j_claim-n	N
naive-j_player-n	N
naive-j_drawing-n	N
naive-j_picture-n	N
naive-j_model-n	N
naive-j_psychology-n	N
naive-j_manager-n	N
naive-j_brother-n	N
naive-j_personality-n	N
naive-j_son-n	N
naive-j_statement-n	N
naive-j_person-n	N
naive-j_innocence-n	N
naive-j_hero-n	N
naive-j_consumer-n	N
naive-j_reader-n	N
naive-j_celebration-n	N
naive-j_painting-n	N
naive-j_ignorance-n	N
naive-j_interpretation-n	N
naive-j_perspective-n	N
naive-j_mind-n	N
naive-j_style-n	N
naive-j_victim-n	N
naive-j_eye-n	N
naive-j_woman-n	N
naive-j_creature-n	N
naive-j_position-n	N
naive-j_idealism-n	N
naive-j_lover-n	N
naive-j_realism-n	N
naive-j_honesty-n	N
naive-j_love-n	N
naive-j_theory-n	N
naive-j_answer-n	N
nasty-j_germ-n	N
nasty-j_teacher-n	N
nasty-j_review-n	N
nasty-j_look-n	N
nasty-j_bump-n	N
nasty-j_work-n	N
nasty-j_spot-n	N
nasty-j_edge-n	N
nasty-j_condition-n	N
nasty-j_surprise-n	N
nasty-j_case-n	N
nasty-j_person-n	N
nasty-j_card-n	N
nasty-j_shit-n	N
nasty-j_party-n	N
nasty-j_sex-n	N
nasty-j_mind-n	N
nasty-j_comment-n	N
nasty-j_place-n	N
nasty-j_wind-n	N
nasty-j_fall-n	N
nasty-j_outbreak-n	N
nasty-j_time-n	N
nasty-j_aspect-n	N
nasty-j_version-n	N
nasty-j_reaction-n	N
nasty-j_illness-n	N
nasty-j_message-n	N
nasty-j_drug-n	N
nasty-j_thing-n	N
nasty-j_image-n	N
nasty-j_thought-n	N
nasty-j_bacterium-n	N
nasty-j_sound-n	N
nasty-j_cough-n	N
nasty-j_call-n	N
nasty-j_suspicion-n	N
nasty-j_name-n	N
nasty-j_scene-n	N
nasty-j_temper-n	N
nasty-j_attitude-n	N
nasty-j_experience-n	N
nasty-j_beast-n	N
nasty-j_medicine-n	N
nasty-j_rumour-n	N
nasty-j_hole-n	N
nasty-j_traps-n	N
nasty-j_business-n	N
nasty-j_emails-n	N
nasty-j_drop-n	N
ripe-j_barley-n	N
ripe-j_experience-n	N
ripe-j_month-n	N
ripe-j_harvest-n	N
ripe-j_skin-n	N
ripe-j_bean-n	N
ripe-j_nut-n	N
ripe-j_tree-n	N
ripe-j_fig-n	N
ripe-j_one-n	N
ripe-j_cheese-n	N
ripe-j_topic-n	N
ripe-j_target-n	N
ripe-j_site-n	N
ripe-j_palate-n	N
ripe-j_bit-n	N
ripe-j_bud-n	N
ripe-j_berry-n	N
ripe-j_shock-n	N
ripe-j_fish-n	N
ripe-j_industry-n	N
ripe-j_red-n	N
ripe-j_climate-n	N
ripe-j_area-n	N
ripe-j_lemon-n	N
ripe-j_fruit-n	N
ripe-j_lip-n	N
ripe-j_wine-n	N
ripe-j_grain-n	N
ripe-j_moment-n	N
ripe-j_taste-n	N
ripe-j_field-n	N
ripe-j_bunch-n	N
ripe-j_world-n	N
ripe-j_market-n	N
ripe-j_smell-n	N
ripe-j_product-n	N
ripe-j_subject-n	N
ripe-j_opportunity-n	N
ripe-j_drop-n	N
ripe-j_pod-n	N
ripe-j_raspberry-n	N
ripe-j_flower-n	N
ripe-j_condition-n	N
ripe-j_barn-n	N
ripe-j_city-n	N
ripe-j_orange-n	N
ripe-j_flavor-n	N
ripe-j_vintage-n	N
ripe-j_region-n	N
safe-j_district-n	N
safe-j_solution-n	N
safe-j_connection-n	N
safe-j_separation-n	N
safe-j_source-n	N
safe-j_behavior-n	N
safe-j_stronghold-n	N
safe-j_topic-n	N
safe-j_lighting-n	N
safe-j_club-n	N
safe-j_venue-n	N
safe-j_jump-n	N
safe-j_medium-n	N
safe-j_transition-n	N
safe-j_expedition-n	N
safe-j_card-n	N
safe-j_programme-n	N
safe-j_hand-n	N
safe-j_conclusion-n	N
safe-j_flight-n	N
safe-j_event-n	N
safe-j_wood-n	N
safe-j_circuit-n	N
safe-j_spot-n	N
safe-j_zone-n	N
safe-j_night-n	N
safe-j_experience-n	N
safe-j_running-n	N
safe-j_group-n	N
safe-j_statement-n	N
safe-j_confine-n	N
safe-j_copy-n	N
safe-j_charge-n	N
safe-j_arrangement-n	N
safe-j_walkway-n	N
safe-j_surface-n	N
safe-j_railway-n	N
safe-j_island-n	N
safe-j_word-n	N
safe-j_construction-n	N
safe-j_execution-n	N
safe-j_recommendation-n	N
safe-j_people-n	N
safe-j_water-n	N
safe-j_speed-n	N
safe-j_withdrawal-n	N
safe-j_model-n	N
safe-j_garden-n	N
safe-j_signal-n	N
safe-j_house-n	N
severe-j_harassment-n	N
severe-j_neglect-n	N
severe-j_case-n	N
severe-j_division-n	N
severe-j_typhoon-n	N
severe-j_morbidity-n	N
severe-j_type-n	N
severe-j_phobia-n	N
severe-j_trouble-n	N
severe-j_eczema-n	N
severe-j_clash-n	N
severe-j_disadvantage-n	N
severe-j_dose-n	N
severe-j_casualty-n	N
severe-j_tension-n	N
severe-j_hypertension-n	N
severe-j_disability-n	N
severe-j_tornado-n	N
severe-j_toxicity-n	N
severe-j_episode-n	N
severe-j_battle-n	N
severe-j_test-n	N
severe-j_wave-n	N
severe-j_course-n	N
severe-j_eye-n	N
severe-j_collision-n	N
severe-j_illness-n	N
severe-j_split-n	N
severe-j_obstruction-n	N
severe-j_competition-n	N
severe-j_defect-n	N
severe-j_pain-n	N
severe-j_distortion-n	N
severe-j_budget-n	N
severe-j_man-n	N
severe-j_climate-n	N
severe-j_discomfort-n	N
severe-j_wind-n	N
severe-j_syndrome-n	N
severe-j_disease-n	N
severe-j_bombing-n	N
severe-j_exhaustion-n	N
severe-j_degradation-n	N
severe-j_discrimination-n	N
severe-j_gale-n	N
severe-j_control-n	N
severe-j_manner-n	N
severe-j_spell-n	N
severe-j_involvement-n	N
severe-j_factor-n	N
stable-j_theory-n	N
stable-j_income-n	N
stable-j_sector-n	N
stable-j_outlook-n	N
stable-j_door-n	N
stable-j_housing-n	N
stable-j_link-n	N
stable-j_infrastructure-n	N
stable-j_os-n	N
stable-j_visit-n	N
stable-j_house-n	N
stable-j_way-n	N
stable-j_ride-n	N
stable-j_view-n	N
stable-j_condition-n	N
stable-j_footing-n	N
stable-j_coalition-n	N
stable-j_ankle-n	N
stable-j_community-n	N
stable-j_disease-n	N
stable-j_union-n	N
stable-j_element-n	N
stable-j_cycle-n	N
stable-j_supply-n	N
stable-j_estimate-n	N
stable-j_behaviour-n	N
stable-j_shoe-n	N
stable-j_thing-n	N
stable-j_boy-n	N
stable-j_mechanism-n	N
stable-j_structure-n	N
stable-j_representation-n	N
stable-j_design-n	N
stable-j_demand-n	N
stable-j_member-n	N
stable-j_particle-n	N
stable-j_framework-n	N
stable-j_block-n	N
stable-j_inflation-n	N
stable-j_measurement-n	N
stable-j_stream-n	N
stable-j_conformation-n	N
stable-j_object-n	N
stable-j_bond-n	N
stable-j_surface-n	N
stable-j_reading-n	N
stable-j_yard-n	N
stable-j_club-n	N
stable-j_point-n	N
stable-j_composition-n	N
vile-j_policy-n	N
vile-j_murder-n	N
vile-j_book-n	N
vile-j_people-n	N
vile-j_mother-n	N
vile-j_disease-n	N
vile-j_man-n	N
vile-j_being-n	N
vile-j_business-n	N
vile-j_language-n	N
vile-j_anything-n	N
vile-j_deed-n	N
vile-j_stuff-n	N
vile-j_propaganda-n	N
vile-j_taste-n	N
vile-j_regime-n	N
vile-j_criminal-n	N
vile-j_word-n	N
vile-j_government-n	N
vile-j_idea-n	N
vile-j_family-n	N
vile-j_prejudice-n	N
vile-j_person-n	N
vile-j_dictator-n	N
vile-j_body-n	N
vile-j_sin-n	N
vile-j_traitor-n	N
vile-j_race-n	N
vile-j_hand-n	N
vile-j_liquid-n	N
vile-j_brew-n	N
vile-j_rumour-n	N
vile-j_exploitation-n	N
vile-j_manner-n	N
vile-j_kind-n	N
vile-j_experience-n	N
vile-j_view-n	N
vile-j_picture-n	N
vile-j_form-n	N
vile-j_aspect-n	N
vile-j_piece-n	N
vile-j_joke-n	N
vile-j_creature-n	N
vile-j_trade-n	N
vile-j_one-n	N
vile-j_remark-n	N
vile-j_name-n	N
vile-j_organisation-n	N
vile-j_habit-n	N
vile-j_dog-n	N
white-j_ridge-n	N
white-j_root-n	N
white-j_project-n	N
white-j_worm-n	N
white-j_fog-n	N
white-j_chick-n	N
white-j_bed-n	N
white-j_shrimp-n	N
white-j_compound-n	N
white-j_gown-n	N
white-j_supremacy-n	N
white-j_bull-n	N
white-j_reproduction-n	N
white-j_dancer-n	N
white-j_city-n	N
white-j_licence-n	N
white-j_minister-n	N
white-j_umbrella-n	N
white-j_face-n	N
white-j_household-n	N
white-j_pant-n	N
white-j_bay-n	N
white-j_separatist-n	N
white-j_fence-n	N
white-j_workbook-n	N
white-j_settlement-n	N
white-j_lighthouse-n	N
white-j_citizen-n	N
white-j_cube-n	N
white-j_plumage-n	N
white-j_bread-n	N
white-j_hill-n	N
white-j_adventure-n	N
white-j_half-n	N
white-j_knight-n	N
white-j_monument-n	N
white-j_event-n	N
white-j_voter-n	N
white-j_magazine-n	N
white-j_brick-n	N
white-j_bag-n	N
white-j_patient-n	N
white-j_source-n	N
white-j_producer-n	N
white-j_sack-n	N
white-j_growth-n	N
white-j_whale-n	N
white-j_badge-n	N
white-j_pupil-n	N
white-j_button-n	N
wide-j_arena-n	N
wide-j_viewing-n	N
wide-j_website-n	N
wide-j_loop-n	N
wide-j_container-n	N
wide-j_horizon-n	N
wide-j_reason-n	N
wide-j_overview-n	N
wide-j_path-n	N
wide-j_product-n	N
wide-j_trend-n	N
wide-j_school-n	N
wide-j_reporting-n	N
wide-j_aperture-n	N
wide-j_staircase-n	N
wide-j_block-n	N
wide-j_house-n	N
wide-j_involvement-n	N
wide-j_trade-n	N
wide-j_stock-n	N
wide-j_thoroughfare-n	N
wide-j_teaching-n	N
wide-j_figure-n	N
wide-j_ministry-n	N
wide-j_variance-n	N
wide-j_agenda-n	N
wide-j_benefit-n	N
wide-j_way-n	N
wide-j_situation-n	N
wide-j_war-n	N
wide-j_vista-n	N
wide-j_record-n	N
wide-j_obligation-n	N
wide-j_reputation-n	N
wide-j_avenue-n	N
wide-j_perspective-n	N
wide-j_scale-n	N
wide-j_impact-n	N
wide-j_connotation-n	N
wide-j_influence-n	N
wide-j_ball-n	N
wide-j_gully-n	N
wide-j_stair-n	N
wide-j_conclusion-n	N
wide-j_function-n	N
wide-j_disparity-n	N
wide-j_tip-n	N
wide-j_aspiration-n	N
wide-j_sphere-n	N
wide-j_detail-n	N
